1013,1020,1020,1020,1020,1017,1017,1017,1017,1020,1014,1014,1014,1014,1020,1020,1020,1020,1020,1020,1020,1020,1020,1017,1017,1017,1017,1014,1014,1020,1020,1020,1020,1014,1014,1014,1014,1014,1020,1013
1013,0,0,0,0,0,0,0,0,0,0,0,0,0,0,0,0,0,0,0,0,0,0,0,0,0,0,0,0,0,0,0,0,0,0,0,0,0,0,1013
1013,0,0,0,0,0,0,0,0,0,0,0,0,0,0,0,0,0,0,0,0,0,0,0,0,0,0,0,0,0,0,0,0,0,0,0,0,0,0,1013
1013,0,0,0,0,0,0,0,0,0,0,0,0,0,0,0,0,0,0,0,0,0,0,0,0,0,0,0,0,0,0,0,0,0,0,0,0,0,0,1013
1022,0,0,0,0,0,0,0,0,0,0,0,0,0,0,0,0,0,0,0,0,0,0,0,0,0,0,0,0,0,0,0,0,0,0,0,0,0,0,1015
1022,0,0,0,0,0,0,833,831,831,0,831,831,838,0,0,0,0,0,0,0,0,0,0,0,0,0,0,0,0,0,0,0,0,0,0,0,0,0,1013
1022,0,0,0,0,0,0,830,0,0,0,0,0,830,0,0,0,0,0,0,0,0,0,0,0,0,0,0,0,0,0,0,0,0,0,0,0,0,0,1013
1022,0,0,0,0,0,0,834,0,0,0,0,0,834,0,0,0,0,0,0,0,0,0,0,0,0,0,0,0,0,0,0,0,0,0,0,0,0,0,1015
1013,0,0,0,0,0,0,0,0,0,0,0,0,0,0,0,0,0,0,0,0,0,0,0,0,0,0,0,0,0,0,0,0,0,0,0,0,0,0,1013
1013,0,0,0,0,0,0,0,0,0,0,0,0,0,0,0,0,0,0,0,0,0,0,0,0,0,0,0,0,833,831,831,0,831,831,838,0,0,0,1013
1013,0,0,0,0,0,0,0,0,0,0,0,0,0,0,0,0,0,0,0,0,0,0,0,0,0,0,0,0,830,0,0,0,0,0,830,0,0,0,1013
1022,0,0,0,0,0,0,837,834,0,0,0,834,837,0,0,0,0,0,0,0,0,0,0,0,0,0,0,0,834,0,0,0,0,0,834,0,0,0,1013
1013,0,0,0,0,0,0,0,0,0,0,0,0,0,0,0,0,0,0,0,0,0,0,0,0,0,0,0,0,0,0,0,0,0,0,0,0,0,0,1015
1013,0,0,0,0,0,0,0,0,0,0,0,0,0,0,0,0,0,0,0,0,0,0,0,0,0,0,0,0,0,0,0,0,0,0,0,0,0,0,1013
1015,0,0,0,0,0,0,0,0,0,0,0,0,0,0,0,0,0,0,0,0,0,0,0,0,0,0,0,0,0,0,0,0,0,0,0,0,0,0,1013
1015,0,0,0,0,0,0,0,0,0,0,0,0,0,0,0,0,0,0,0,0,0,0,0,0,0,0,0,0,837,834,0,0,0,834,837,0,0,0,1013
1015,0,0,0,0,0,0,0,0,0,0,0,0,0,0,839,0,0,0,0,0,0,0,0,0,839,0,0,0,0,0,0,0,0,0,0,0,0,0,1015
1015,0,0,0,0,0,0,0,0,0,0,0,0,0,0,830,0,833,831,831,0,831,831,838,0,830,0,0,0,0,0,0,0,0,0,0,0,0,0,1015
1013,0,0,0,0,0,0,0,0,0,0,0,0,0,0,830,0,830,0,0,0,0,0,830,0,830,0,0,0,0,0,0,0,0,0,0,0,0,0,1015
1013,0,0,0,0,0,0,0,0,0,0,0,0,0,0,830,0,834,0,0,0,0,0,834,0,830,0,0,0,0,0,0,0,0,0,0,0,0,0,1015
1013,0,0,0,0,0,0,0,0,0,0,0,0,0,0,830,0,0,0,0,0,0,0,0,0,830,0,0,0,0,0,0,0,0,0,0,0,0,0,1013
1015,0,0,0,0,0,0,0,0,0,0,0,0,0,0,830,0,0,0,0,0,0,0,0,0,830,0,0,0,0,0,0,0,0,0,0,0,0,0,1013
1015,0,0,0,0,0,0,0,0,0,0,0,0,0,0,830,0,0,0,0,0,0,0,0,0,830,0,0,0,0,0,0,0,0,0,0,0,0,0,1013
1013,0,0,0,0,0,0,0,0,0,0,0,0,0,0,830,0,837,834,0,0,0,834,837,0,830,0,0,0,0,0,0,0,0,0,0,0,0,0,1013
1015,0,0,0,0,0,0,0,0,0,0,0,0,0,0,834,0,0,0,0,0,0,0,0,0,834,0,0,0,0,0,0,0,0,0,0,0,0,0,1023
1013,0,0,0,0,0,0,0,0,0,0,0,0,0,0,0,0,0,0,0,0,0,0,0,0,0,0,0,0,0,0,0,0,0,0,0,0,0,0,1023
1023,0,0,0,0,0,0,0,0,0,0,0,0,0,0,0,0,0,0,0,0,0,0,0,0,0,0,0,0,0,0,0,0,0,0,0,0,0,0,1023
1023,0,0,0,0,0,0,0,0,0,0,0,0,0,0,0,0,0,0,0,0,0,0,0,0,0,0,0,0,0,0,0,0,0,0,0,0,0,0,1023
1013,0,0,0,0,0,0,0,0,0,0,0,0,0,0,0,0,0,0,0,0,0,0,0,0,0,0,0,0,0,0,0,0,0,0,0,0,0,0,1023
1013,1017,1017,1017,1017,1018,1018,1018,1018,1018,1018,1018,1018,1018,1017,1017,1017,1018,1018,1018,1018,1017,1017,1018,1017,1017,1017,1017,1018,1018,1018,1018,1018,1017,1018,1018,1018,1018,1018,1013
